cesarea;espontaneo;instrumentado;sin_informacion;total ;ano;id_regimen_regimen;id_area_area_regimen
52;130;6;0;188;2008;sub;1
82;150;2;0;234;2009;sub;1
48;120;7;0;175;2010;sub;1
70;142;1;0;213;2011;sub;1
61;124;6;0;191;2012;sub;1
73;169;4;0;246;2013;sub;1
78;147;4;0;229;2014;sub;1
68;146;5;0;219;2015;sub;1
49;134;4;0;187;2016;sub;1
51;99;4;0;154;2017;sub;1
55;100;3;0;158;2018;sub;1
325;443;27;7;802;2008;con;1
328;478;31;6;843;2009;con;1
331;450;36;0;817;2010;con;1
361;515;44;0;920;2011;con;1
312;446;27;0;785;2012;con;1
435;502;25;0;962;2013;con;1
424;479;23;0;926;2014;con;1
419;456;19;0;894;2015;con;1
440;514;16;0;970;2016;con;1
365;427;19;0;811;2017;con;1
291;367;15;1;674;2018;con;1
15;18;3;1;37;2008;esp;1
10;20;2;0;32;2009;esp;1
11;25;2;0;38;2010;esp;1
19;17;3;0;39;2011;esp;1
12;23;1;0;36;2012;esp;1
20;19;2;0;41;2013;esp;1
22;22;2;0;46;2014;esp;1
19;13;3;0;35;2015;esp;1
16;18;2;0;36;2016;esp;1
11;19;0;0;30;2017;esp;1
12;14;3;0;29;2018;esp;1
63;146;10;0;219;2008;nas;1
60;121;6;0;187;2009;nas;1
27;70;6;0;103;2010;nas;1
45;79;9;0;133;2011;nas;1
26;80;2;0;108;2012;nas;1
37;50;5;0;92;2013;nas;1
29;48;2;0;79;2014;nas;1
15;31;1;0;47;2015;nas;1
10;20;2;0;32;2016;nas;1
8;22;1;0;31;2017;nas;1
20;34;1;0;55;2018;nas;1
54;80;4;0;138;2008;sub;2
48;112;5;0;165;2009;sub;2
51;100;1;0;152;2010;sub;2
65;123;5;0;193;2011;sub;2
71;122;2;0;195;2012;sub;2
84;163;3;0;250;2013;sub;2
56;120;1;0;177;2014;sub;2
64;118;4;0;186;2015;sub;2
56;86;1;0;143;2016;sub;2
53;79;1;0;133;2017;sub;2
55;101;1;0;157;2018;sub;2
557;691;65;6;1319;2008;con;2
569;646;97;4;1316;2009;con;2
642;641;64;3;1350;2010;con;2
625;706;70;0;1401;2011;con;2
595;666;45;0;1306;2012;con;2
624;648;47;0;1319;2013;con;2
659;623;51;0;1333;2014;con;2
654;604;46;0;1304;2015;con;2
657;617;50;0;1324;2016;con;2
614;590;45;0;1249;2017;con;2
530;502;51;0;1083;2018;con;2
17;20;3;0;40;2008;esp;2
15;26;4;0;45;2009;esp;2
23;17;4;1;45;2010;esp;2
25;23;0;0;48;2011;esp;2
18;34;6;0;58;2012;esp;2
32;21;2;0;55;2013;esp;2
25;20;2;0;47;2014;esp;2
23;14;1;0;38;2015;esp;2
35;16;1;0;52;2016;esp;2
25;13;1;0;39;2017;esp;2
13;21;1;0;35;2018;esp;2
70;151;1;0;222;2008;nas;2
81;132;3;0;216;2009;nas;2
52;76;1;0;129;2010;nas;2
54;81;3;0;138;2011;nas;2
44;75;1;0;120;2012;nas;2
24;54;0;0;78;2013;nas;2
29;48;0;0;77;2014;nas;2
15;28;1;0;44;2015;nas;2
18;18;0;0;36;2016;nas;2
15;16;0;0;31;2017;nas;2
18;37;0;0;55;2018;nas;2
841;1708;37;10;2596;2008;sub;3
808;1751;38;12;2609;2009;sub;3
817;2032;30;0;2879;2010;sub;3
791;1779;47;0;2617;2011;sub;3
801;1798;36;0;2635;2012;sub;3
830;1779;42;1;2652;2013;sub;3
861;1756;38;0;2655;2014;sub;3
820;1736;57;0;2613;2015;sub;3
824;1606;36;0;2466;2016;sub;3
850;1442;36;0;2328;2017;sub;3
746;1457;23;0;2226;2018;sub;3
2148;3740;253;37;6178;2008;con;3
2284;3790;237;36;6347;2009;con;3
2358;3690;254;3;6305;2010;con;3
2500;3668;227;3;6398;2011;con;3
2554;3805;226;0;6585;2012;con;3
2594;3607;198;0;6399;2013;con;3
2480;3734;160;0;6374;2014;con;3
2850;4124;172;0;7146;2015;con;3
2796;4108;185;0;7089;2016;con;3
2617;3878;145;0;6640;2017;con;3
2487;3582;134;1;6204;2018;con;3
67;141;12;2;222;2008;esp;3
71;139;7;3;220;2009;esp;3
71;147;9;1;228;2010;esp;3
72;144;14;0;230;2011;esp;3
80;124;5;0;209;2012;esp;3
79;123;17;0;219;2013;esp;3
87;127;10;0;224;2014;esp;3
98;109;5;0;212;2015;esp;3
95;110;7;0;212;2016;esp;3
93;109;8;0;210;2017;esp;3
79;96;3;0;178;2018;esp;3
644;1365;33;5;2047;2008;nas;3
533;1203;22;6;1764;2009;nas;3
350;860;15;0;1225;2010;nas;3
379;792;16;0;1187;2011;nas;3
310;638;16;0;964;2012;nas;3
265;562;12;0;839;2013;nas;3
218;402;13;0;633;2014;nas;3
151;304;10;0;465;2015;nas;3
111;189;4;0;304;2016;nas;3
100;144;3;0;247;2017;nas;3
229;328;4;0;561;2018;nas;3
52;124;5;1;182;2008;sub;4
57;133;3;0;193;2009;sub;4
67;136;1;0;204;2010;sub;4
51;100;1;0;152;2011;sub;4
68;109;3;0;180;2012;sub;4
65;114;3;0;182;2013;sub;4
61;94;3;0;158;2014;sub;4
56;95;3;0;154;2015;sub;4
49;69;0;0;118;2016;sub;4
51;56;1;0;108;2017;sub;4
30;71;1;0;102;2018;sub;4
676;565;77;9;1327;2008;con;4
772;623;63;5;1463;2009;con;4
907;728;90;3;1728;2010;con;4
897;571;91;1;1560;2011;con;4
965;689;74;0;1728;2012;con;4
902;603;84;0;1589;2013;con;4
956;606;86;0;1648;2014;con;4
985;567;89;0;1641;2015;con;4
1026;670;89;0;1785;2016;con;4
986;674;72;0;1732;2017;con;4
836;513;65;0;1414;2018;con;4
25;25;4;0;54;2008;esp;4
17;23;4;1;45;2009;esp;4
27;23;2;0;52;2010;esp;4
21;26;3;0;50;2011;esp;4
40;25;3;0;68;2012;esp;4
38;30;3;0;71;2013;esp;4
27;21;4;0;52;2014;esp;4
20;12;2;0;34;2015;esp;4
29;32;3;0;64;2016;esp;4
21;21;3;0;45;2017;esp;4
22;19;2;0;43;2018;esp;4
45;124;4;0;173;2008;nas;4
64;98;6;0;168;2009;nas;4
60;85;5;0;150;2010;nas;4
50;64;8;0;122;2011;nas;4
53;49;4;0;106;2012;nas;4
58;64;5;0;127;2013;nas;4
43;32;4;0;79;2014;nas;4
63;33;2;0;98;2015;nas;4
43;28;7;0;78;2016;nas;4
50;31;5;0;86;2017;nas;4
49;47;8;0;104;2018;nas;4
1441;3247;64;21;4773;2008;sub;5
1238;3195;82;10;4525;2009;sub;5
1346;3434;61;2;4843;2010;sub;5
1287;3113;50;0;4450;2011;sub;5
1352;3041;42;0;4435;2012;sub;5
1233;2467;31;0;3731;2013;sub;5
1114;2619;50;0;3783;2014;sub;5
1108;2326;38;0;3472;2015;sub;5
941;2154;32;0;3127;2016;sub;5
1035;2114;33;0;3182;2017;sub;5
1002;2195;28;0;3225;2018;sub;5
1565;3007;162;23;4757;2008;con;5
1624;2783;172;22;4601;2009;con;5
1716;2780;182;1;4679;2010;con;5
1686;2721;150;2;4559;2011;con;5
1847;2902;143;0;4892;2012;con;5
2069;2836;105;0;5010;2013;con;5
2164;3129;157;0;5450;2014;con;5
2300;3514;128;0;5942;2015;con;5
2401;3442;126;0;5969;2016;con;5
2156;3291;101;1;5549;2017;con;5
2055;3146;101;0;5302;2018;con;5
59;110;12;3;184;2008;esp;5
66;103;11;6;186;2009;esp;5
55;122;14;2;193;2010;esp;5
81;141;9;0;231;2011;esp;5
66;128;10;0;204;2012;esp;5
66;109;12;0;187;2013;esp;5
100;115;10;0;225;2014;esp;5
91;113;12;0;216;2015;esp;5
85;108;4;0;197;2016;esp;5
68;108;7;0;183;2017;esp;5
70;96;3;0;169;2018;esp;5
559;1552;32;6;2149;2008;nas;5
606;1603;31;5;2245;2009;nas;5
357;1038;21;0;1416;2010;nas;5
411;1108;13;0;1532;2011;nas;5
350;871;4;0;1225;2012;nas;5
354;784;4;0;1142;2013;nas;5
334;765;6;0;1105;2014;nas;5
236;449;6;0;691;2015;nas;5
165;328;2;0;495;2016;nas;5
165;280;3;0;448;2017;nas;5
266;405;3;0;674;2018;nas;5
7464;15872;447;79;23862;2008;sub;6
7050;15993;425;54;23522;2009;sub;6
7015;16615;383;5;24018;2010;sub;6
7078;15429;421;2;22930;2011;sub;6
7195;14913;363;3;22474;2012;sub;6
7192;14018;321;2;21533;2013;sub;6
6910;14062;374;1;21347;2014;sub;6
6832;13342;362;0;20536;2015;sub;6
5987;11964;292;1;18244;2016;sub;6
6189;11699;246;0;18134;2017;sub;6
5775;11317;209;0;17301;2018;sub;6
27955;40353;3373;347;72028;2008;con;6
29101;38450;3236;399;71186;2009;con;6
28922;37430;3283;77;69712;2010;con;6
29949;35917;2930;21;68817;2011;con;6
30320;36712;2822;0;69854;2012;con;6
31345;35676;2449;1;69471;2013;con;6
32104;37492;2309;0;71905;2014;con;6
33577;38552;2291;0;74420;2015;con;6
33689;37855;2173;0;73717;2016;con;6
30780;35834;1978;1;68593;2017;con;6
28278;32904;1675;2;62859;2018;con;6
1179;1680;211;28;3098;2008;esp;6
1229;1656;220;47;3152;2009;esp;6
1275;1715;206;32;3228;2010;esp;6
1345;1741;212;0;3298;2011;esp;6
1256;1651;220;0;3127;2012;esp;6
1437;1582;171;0;3190;2013;esp;6
1476;1523;150;0;3149;2014;esp;6
1387;1449;113;0;2949;2015;esp;6
1331;1292;119;0;2742;2016;esp;6
1214;1166;92;0;2472;2017;esp;6
1009;1065;68;0;2142;2018;esp;6
5298;12078;410;35;17821;2008;nas;6
5334;11782;346;41;17503;2009;nas;6
3811;8980;218;7;13016;2010;nas;6
3471;7472;227;0;11170;2011;nas;6
3101;6553;196;3;9853;2012;nas;6
3032;5881;128;1;9042;2013;nas;6
2515;4792;131;2;7440;2014;nas;6
1805;2997;70;1;4873;2015;nas;6
1530;2367;53;0;3950;2016;nas;6
1120;1686;49;0;2855;2017;nas;6
2027;2949;70;1;5047;2018;nas;6
340;640;15;2;997;2008;sub;7
371;704;14;0;1089;2009;sub;7
375;714;22;1;1112;2010;sub;7
407;758;20;0;1185;2011;sub;7
342;639;14;0;995;2012;sub;7
376;568;12;0;956;2013;sub;7
395;609;7;0;1011;2014;sub;7
417;626;9;0;1052;2015;sub;7
308;532;12;0;852;2016;sub;7
376;493;13;0;882;2017;sub;7
327;582;6;0;915;2018;sub;7
3331;4634;448;29;8442;2008;con;7
3431;4407;441;55;8334;2009;con;7
3266;4258;429;14;7967;2010;con;7
3440;3870;374;0;7684;2011;con;7
3330;3816;336;0;7482;2012;con;7
3203;3894;306;0;7403;2013;con;7
3673;4066;282;0;8021;2014;con;7
3604;3798;252;0;7654;2015;con;7
3517;3661;261;0;7439;2016;con;7
3173;3452;256;0;6881;2017;con;7
2981;3270;195;0;6446;2018;con;7
134;166;27;3;330;2008;esp;7
170;193;10;5;378;2009;esp;7
153;203;32;2;390;2010;esp;7
179;194;28;0;401;2011;esp;7
153;184;20;0;357;2012;esp;7
168;190;21;0;379;2013;esp;7
207;184;15;0;406;2014;esp;7
137;158;18;0;313;2015;esp;7
153;153;15;0;321;2016;esp;7
113;108;13;0;234;2017;esp;7
118;107;7;0;232;2018;esp;7
508;1131;36;1;1676;2008;nas;7
490;952;25;2;1469;2009;nas;7
342;727;21;0;1090;2010;nas;7
334;592;10;0;936;2011;nas;7
272;518;7;0;797;2012;nas;7
311;463;12;0;786;2013;nas;7
247;369;7;0;623;2014;nas;7
154;203;5;0;362;2015;nas;7
90;99;3;0;192;2016;nas;7
79;100;1;0;180;2017;nas;7
178;201;0;0;379;2018;nas;7
163;273;6;0;442;2008;sub;8
142;259;9;2;412;2009;sub;8
156;344;10;0;510;2010;sub;8
152;310;17;0;479;2011;sub;8
146;296;7;0;449;2012;sub;8
157;277;2;0;436;2013;sub;8
196;273;1;0;470;2014;sub;8
212;280;10;0;502;2015;sub;8
188;252;3;0;443;2016;sub;8
140;232;4;0;376;2017;sub;8
143;251;8;0;402;2018;sub;8
1615;2024;189;14;3842;2008;con;8
1661;1969;194;10;3834;2009;con;8
1539;1806;179;5;3529;2010;con;8
1628;1674;172;0;3474;2011;con;8
1645;1737;153;0;3535;2012;con;8
1653;1715;134;0;3502;2013;con;8
1717;1750;150;0;3617;2014;con;8
1660;1698;138;0;3496;2015;con;8
1708;1710;133;0;3551;2016;con;8
1591;1482;111;0;3184;2017;con;8
1475;1433;99;0;3007;2018;con;8
80;89;7;2;178;2008;esp;8
87;89;16;5;197;2009;esp;8
65;92;14;4;175;2010;esp;8
77;82;14;0;173;2011;esp;8
72;88;17;0;177;2012;esp;8
89;90;10;0;189;2013;esp;8
73;74;10;0;157;2014;esp;8
78;70;8;0;156;2015;esp;8
77;52;6;0;135;2016;esp;8
86;55;2;0;143;2017;esp;8
62;59;8;0;129;2018;esp;8
202;351;13;4;570;2008;nas;8
181;343;13;4;541;2009;nas;8
134;296;7;1;438;2010;nas;8
98;156;10;0;264;2011;nas;8
85;175;5;1;266;2012;nas;8
107;145;1;0;253;2013;nas;8
59;89;3;0;151;2014;nas;8
51;51;6;0;108;2015;nas;8
33;50;1;0;84;2016;nas;8
36;33;2;0;71;2017;nas;8
61;106;3;0;170;2018;nas;8
819;1583;54;11;2467;2008;sub;9
781;1686;44;5;2516;2009;sub;9
775;1785;50;0;2610;2010;sub;9
874;1840;77;0;2791;2011;sub;9
1017;1852;60;0;2929;2012;sub;9
1170;2022;61;0;3253;2013;sub;9
1110;1939;76;0;3125;2014;sub;9
1028;1781;64;0;2873;2015;sub;9
970;1463;48;0;2481;2016;sub;9
953;1531;50;0;2534;2017;sub;9
820;1297;25;0;2142;2018;sub;9
4061;6129;513;61;10764;2008;con;9
4140;5849;446;76;10511;2009;con;9
4202;5786;489;6;10483;2010;con;9
4383;5522;406;3;10314;2011;con;9
4485;5620;471;0;10576;2012;con;9
4536;5447;394;0;10377;2013;con;9
4478;5737;334;0;10549;2014;con;9
4723;6020;349;0;11092;2015;con;9
4797;5715;315;0;10827;2016;con;9
4459;5340;262;0;10061;2017;con;9
4028;4853;202;0;9083;2018;con;9
188;312;43;5;548;2008;esp;9
186;270;49;7;512;2009;esp;9
200;272;40;6;518;2010;esp;9
232;293;42;0;567;2011;esp;9
226;302;43;0;571;2012;esp;9
234;258;28;0;520;2013;esp;9
251;277;26;0;554;2014;esp;9
267;275;14;0;556;2015;esp;9
218;218;31;0;467;2016;esp;9
222;194;15;0;431;2017;esp;9
149;192;5;0;346;2018;esp;9
763;1555;64;5;2387;2008;nas;9
806;1584;63;8;2461;2009;nas;9
633;1414;39;1;2087;2010;nas;9
534;1085;51;0;1670;2011;nas;9
497;1002;43;1;1543;2012;nas;9
377;686;14;0;1077;2013;nas;9
297;520;19;1;837;2014;nas;9
172;304;12;0;488;2015;nas;9
152;204;8;0;364;2016;nas;9
147;187;4;0;338;2017;nas;9
337;458;11;0;806;2018;nas;9
24;48;2;0;74;2008;sub;10
31;45;2;0;78;2009;sub;10
29;54;1;0;84;2010;sub;10
18;43;1;0;62;2011;sub;10
27;63;2;0;92;2012;sub;10
24;69;0;0;93;2013;sub;10
29;60;3;0;92;2014;sub;10
32;66;0;0;98;2015;sub;10
23;43;1;0;67;2016;sub;10
18;49;2;0;69;2017;sub;10
14;37;0;0;51;2018;sub;10
76;110;6;1;193;2008;con;10
86;122;11;1;220;2009;con;10
109;134;15;1;259;2010;con;10
93;104;10;0;207;2011;con;10
108;144;5;0;257;2012;con;10
124;120;6;0;250;2013;con;10
127;140;6;0;273;2014;con;10
107;105;2;0;214;2015;con;10
93;79;5;0;177;2016;con;10
123;112;5;0;240;2017;con;10
80;102;6;0;188;2018;con;10
5;3;0;0;8;2008;esp;10
3;2;0;0;5;2009;esp;10
8;8;1;0;17;2010;esp;10
3;7;0;0;10;2011;esp;10
5;6;3;0;14;2012;esp;10
5;4;2;0;11;2013;esp;10
6;21;1;0;28;2014;esp;10
3;8;0;0;11;2015;esp;10
3;2;0;0;5;2016;esp;10
6;8;0;0;14;2017;esp;10
4;3;1;0;8;2018;esp;10
10;36;1;0;47;2008;nas;10
8;22;1;0;31;2009;nas;10
8;14;2;0;24;2010;nas;10
9;17;0;0;26;2011;nas;10
7;17;0;0;24;2012;nas;10
3;22;0;0;25;2013;nas;10
4;17;0;0;21;2014;nas;10
9;11;1;0;21;2015;nas;10
4;8;0;0;12;2016;nas;10
1;13;1;0;15;2017;nas;10
12;14;0;0;26;2018;nas;10
62;156;3;0;221;2008;sub;11
64;149;4;0;217;2009;sub;11
70;165;4;0;239;2010;sub;11
88;177;4;0;269;2011;sub;11
98;213;2;0;313;2012;sub;11
87;188;9;0;284;2013;sub;11
95;222;5;0;322;2014;sub;11
80;218;2;0;300;2015;sub;11
67;182;6;0;255;2016;sub;11
64;186;1;0;251;2017;sub;11
60;147;4;0;211;2018;sub;11
309;468;41;3;821;2008;con;11
332;426;31;5;794;2009;con;11
335;433;23;2;793;2010;con;11
330;395;29;1;755;2011;con;11
352;409;26;0;787;2012;con;11
350;370;21;0;741;2013;con;11
340;422;14;0;776;2014;con;11
335;405;26;0;766;2015;con;11
342;375;21;0;738;2016;con;11
322;366;15;0;703;2017;con;11
315;321;13;0;649;2018;con;11
26;15;5;1;47;2008;esp;11
15;23;3;3;44;2009;esp;11
22;28;2;0;52;2010;esp;11
13;24;3;0;40;2011;esp;11
22;20;7;0;49;2012;esp;11
20;27;4;0;51;2013;esp;11
24;33;2;0;59;2014;esp;11
5;21;0;0;26;2015;esp;11
23;19;0;0;42;2016;esp;11
19;17;1;0;37;2017;esp;11
21;17;1;0;39;2018;esp;11
113;219;7;1;340;2008;nas;11
86;184;2;3;275;2009;nas;11
51;122;3;0;176;2010;nas;11
49;94;3;0;146;2011;nas;11
40;112;1;0;153;2012;nas;11
40;94;5;0;139;2013;nas;11
27;95;2;0;124;2014;nas;11
24;53;2;0;79;2015;nas;11
16;42;1;0;59;2016;nas;11
19;31;0;0;50;2017;nas;11
56;121;4;0;181;2018;nas;11
107;157;11;1;276;2008;sub;12
85;188;8;0;281;2009;sub;12
68;161;3;0;232;2010;sub;12
87;209;8;0;304;2011;sub;12
79;176;5;0;260;2012;sub;12
115;216;6;0;337;2013;sub;12
110;251;4;0;365;2014;sub;12
107;223;6;0;336;2015;sub;12
90;146;7;1;244;2016;sub;12
78;154;5;0;237;2017;sub;12
94;151;4;0;249;2018;sub;12
1152;1643;145;18;2958;2008;con;12
1055;1430;140;18;2643;2009;con;12
1046;1327;135;1;2509;2010;con;12
1100;1303;99;3;2505;2011;con;12
1090;1262;103;0;2455;2012;con;12
1132;1237;59;0;2428;2013;con;12
1156;1325;89;0;2570;2014;con;12
1111;1354;92;0;2557;2015;con;12
1118;1247;69;0;2434;2016;con;12
906;1081;61;0;2048;2017;con;12
827;970;42;0;1839;2018;con;12
45;79;11;1;136;2008;esp;12
55;57;12;0;124;2009;esp;12
62;67;9;0;138;2010;esp;12
50;76;11;0;137;2011;esp;12
58;66;12;0;136;2012;esp;12
64;64;5;0;133;2013;esp;12
54;55;6;0;115;2014;esp;12
52;64;3;0;119;2015;esp;12
48;63;6;0;117;2016;esp;12
49;58;4;0;111;2017;esp;12
52;54;8;0;114;2018;esp;12
117;242;10;1;370;2008;nas;12
120;267;8;0;395;2009;nas;12
85;177;1;0;263;2010;nas;12
70;152;4;0;226;2011;nas;12
59;127;4;1;191;2012;nas;12
64;112;5;0;181;2013;nas;12
55;72;6;0;133;2014;nas;12
35;36;1;0;72;2015;nas;12
24;29;1;0;54;2016;nas;12
16;18;1;0;35;2017;nas;12
33;47;1;0;81;2018;nas;12
690;1389;50;6;2135;2008;sub;13
590;1199;29;6;1824;2009;sub;13
600;1277;35;0;1912;2010;sub;13
551;1153;36;0;1740;2011;sub;13
509;1064;24;0;1597;2012;sub;13
494;1050;34;0;1578;2013;sub;13
474;977;41;1;1493;2014;sub;13
488;937;34;0;1459;2015;sub;13
418;882;24;0;1324;2016;sub;13
369;869;21;0;1259;2017;sub;13
351;773;16;0;1140;2018;sub;13
1266;2087;146;27;3526;2008;con;13
1340;1978;141;14;3473;2009;con;13
1285;1901;151;2;3339;2010;con;13
1397;1880;108;2;3387;2011;con;13
1382;1918;121;0;3421;2012;con;13
1471;1816;98;0;3385;2013;con;13
1384;1968;86;0;3438;2014;con;13
1463;1971;76;0;3510;2015;con;13
1655;2029;60;0;3744;2016;con;13
1285;1786;67;0;3138;2017;con;13
1287;1722;70;0;3079;2018;con;13
77;100;14;2;193;2008;esp;13
48;84;17;2;151;2009;esp;13
82;90;11;1;184;2010;esp;13
64;105;16;0;185;2011;esp;13
60;85;10;0;155;2012;esp;13
85;112;12;0;209;2013;esp;13
70;81;11;0;162;2014;esp;13
70;76;6;0;152;2015;esp;13
70;65;5;0;140;2016;esp;13
65;55;6;0;126;2017;esp;13
46;51;1;0;98;2018;esp;13
381;801;38;0;1220;2008;nas;13
433;844;23;3;1303;2009;nas;13
212;550;8;0;770;2010;nas;13
216;428;8;0;652;2011;nas;13
210;383;11;0;604;2012;nas;13
205;407;13;0;625;2013;nas;13
133;270;8;0;411;2014;nas;13
79;173;6;0;258;2015;nas;13
57;115;2;0;174;2016;nas;13
51;102;10;0;163;2017;nas;13
117;191;11;0;319;2018;nas;13
865;1693;48;5;2611;2008;sub;14
874;1741;65;4;2684;2009;sub;14
849;1758;59;0;2666;2010;sub;14
813;1620;42;0;2475;2011;sub;14
732;1406;45;1;2184;2012;sub;14
670;1308;42;0;2020;2013;sub;14
695;1413;71;0;2179;2014;sub;14
606;1216;45;0;1867;2015;sub;14
526;1109;46;0;1681;2016;sub;14
434;1034;20;0;1488;2017;sub;14
373;960;35;0;1368;2018;sub;14
1333;2220;138;20;3711;2008;con;14
1411;2157;128;11;3707;2009;con;14
1398;2174;136;5;3713;2010;con;14
1348;2067;125;0;3540;2011;con;14
1340;1999;109;0;3448;2012;con;14
1493;1850;93;0;3436;2013;con;14
1377;2062;81;0;3520;2014;con;14
1581;2118;71;0;3770;2015;con;14
1548;2142;59;0;3749;2016;con;14
1393;1927;74;0;3394;2017;con;14
1184;1702;44;0;2930;2018;con;14
52;92;11;1;156;2008;esp;14
54;79;11;5;149;2009;esp;14
54;98;18;2;172;2010;esp;14
70;98;10;0;178;2011;esp;14
75;104;13;0;192;2012;esp;14
67;72;6;0;145;2013;esp;14
51;93;11;0;155;2014;esp;14
69;78;5;0;152;2015;esp;14
59;75;5;0;139;2016;esp;14
58;69;6;0;133;2017;esp;14
32;41;2;0;75;2018;esp;14
318;780;21;2;1121;2008;nas;14
368;814;31;2;1215;2009;nas;14
242;566;16;1;825;2010;nas;14
240;460;15;0;715;2011;nas;14
210;433;24;0;667;2012;nas;14
155;358;15;0;528;2013;nas;14
158;273;11;0;442;2014;nas;14
81;155;3;0;239;2015;nas;14
85;130;4;0;219;2016;nas;14
60;136;2;0;198;2017;nas;14
104;208;8;0;320;2018;nas;14
223;490;20;2;735;2008;sub;15
181;450;19;0;650;2009;sub;15
184;442;19;0;645;2010;sub;15
186;379;11;1;577;2011;sub;15
195;450;9;0;654;2012;sub;15
177;391;11;0;579;2013;sub;15
149;359;12;0;520;2014;sub;15
159;342;12;0;513;2015;sub;15
117;310;10;0;437;2016;sub;15
126;322;7;0;455;2017;sub;15
113;320;10;0;443;2018;sub;15
339;532;51;5;927;2008;con;15
360;436;30;8;834;2009;con;15
307;429;43;1;780;2010;con;15
318;384;32;0;734;2011;con;15
342;421;38;0;801;2012;con;15
381;459;21;0;861;2013;con;15
456;445;23;0;924;2014;con;15
467;426;26;0;919;2015;con;15
339;458;18;0;815;2016;con;15
448;542;9;0;999;2017;con;15
369;485;21;0;875;2018;con;15
14;31;1;1;47;2008;esp;15
19;20;7;0;46;2009;esp;15
21;24;3;0;48;2010;esp;15
11;14;2;0;27;2011;esp;15
12;23;0;0;35;2012;esp;15
25;29;2;0;56;2013;esp;15
39;27;1;0;67;2014;esp;15
21;15;1;0;37;2015;esp;15
19;20;2;0;41;2016;esp;15
18;21;1;0;40;2017;esp;15
23;13;0;0;36;2018;esp;15
104;247;8;2;361;2008;nas;15
94;220;9;0;323;2009;nas;15
52;172;3;0;227;2010;nas;15
64;149;3;0;216;2011;nas;15
47;149;2;0;198;2012;nas;15
59;131;2;0;192;2013;nas;15
42;86;2;0;130;2014;nas;15
17;54;0;0;71;2015;nas;15
28;40;2;0;70;2016;nas;15
33;40;4;0;77;2017;nas;15
69;128;1;0;198;2018;nas;15
55;109;4;0;168;2008;sub;16
47;73;1;0;121;2009;sub;16
77;231;0;0;308;2010;sub;16
13;18;0;0;31;2011;sub;16
7;6;1;0;14;2012;sub;16
8;16;0;0;24;2013;sub;16
22;42;0;0;64;2014;sub;16
36;75;0;0;111;2015;sub;16
49;108;1;0;158;2016;sub;16
16;31;0;0;47;2017;sub;16
32;27;0;0;59;2018;sub;16
152;240;14;3;409;2008;con;16
125;150;12;0;287;2009;con;16
71;102;8;0;181;2010;con;16
31;31;1;0;63;2011;con;16
4;7;1;0;12;2012;con;16
8;7;1;0;16;2013;con;16
15;24;1;0;40;2014;con;16
100;117;9;0;226;2015;con;16
138;241;12;0;391;2016;con;16
52;78;3;0;133;2017;con;16
85;108;0;0;193;2018;con;16
13;19;0;0;32;2008;esp;16
14;16;0;0;30;2009;esp;16
3;2;0;0;5;2010;esp;16
1;5;0;0;6;2011;esp;16
0;3;0;0;3;2012;esp;16
0;0;0;0;0;2013;esp;16
0;1;0;0;1;2014;esp;16
0;1;0;0;1;2015;esp;16
0;0;0;0;0;2016;esp;16
2;0;0;0;2;2017;esp;16
1;0;0;0;1;2018;esp;16
35;87;4;0;126;2008;nas;16
41;75;1;0;117;2009;nas;16
29;110;0;1;140;2010;nas;16
7;10;0;0;17;2011;nas;16
4;9;1;0;14;2012;nas;16
5;16;1;1;23;2013;nas;16
25;51;3;0;79;2014;nas;16
30;50;0;1;81;2015;nas;16
64;91;0;0;155;2016;nas;16
8;10;0;0;18;2017;nas;16
10;16;2;0;28;2018;nas;16
456;1119;45;4;1624;2008;sub;17
541;1307;26;1;1875;2009;sub;17
367;1005;23;0;1395;2010;sub;17
476;999;38;0;1513;2011;sub;17
545;1054;43;1;1643;2012;sub;17
513;946;19;1;1479;2013;sub;17
430;960;19;0;1409;2014;sub;17
472;1015;18;0;1505;2015;sub;17
330;735;16;0;1081;2016;sub;17
557;924;10;0;1491;2017;sub;17
541;963;14;0;1518;2018;sub;17
4561;5957;569;43;11130;2008;con;17
4783;5612;561;67;11023;2009;con;17
4571;5508;532;17;10628;2010;con;17
4992;5382;553;2;10929;2011;con;17
5023;5477;495;0;10995;2012;con;17
5298;5457;449;0;11204;2013;con;17
5474;5670;420;0;11564;2014;con;17
5655;5870;384;0;11909;2015;con;17
5536;5352;378;0;11266;2016;con;17
5107;5617;384;0;11108;2017;con;17
4737;4934;320;0;9991;2018;con;17
165;210;24;4;403;2008;esp;17
163;226;31;7;427;2009;esp;17
164;237;19;5;425;2010;esp;17
189;209;22;0;420;2011;esp;17
157;196;26;0;379;2012;esp;17
196;203;17;0;416;2013;esp;17
214;172;22;0;408;2014;esp;17
199;190;19;0;408;2015;esp;17
194;138;13;0;345;2016;esp;17
145;127;11;0;283;2017;esp;17
128;125;7;0;260;2018;esp;17
743;1660;67;3;2473;2008;nas;17
676;1639;46;3;2364;2009;nas;17
655;1536;35;0;2226;2010;nas;17
436;1097;40;0;1573;2011;nas;17
457;935;38;0;1430;2012;nas;17
523;1047;25;0;1595;2013;nas;17
471;966;15;0;1452;2014;nas;17
381;616;6;0;1003;2015;nas;17
427;623;6;0;1056;2016;nas;17
150;218;4;0;372;2017;nas;17
151;168;5;1;325;2018;nas;17
9;24;1;0;34;2008;sub;18
7;14;0;0;21;2009;sub;18
3;19;0;0;22;2010;sub;18
5;6;0;0;11;2011;sub;18
11;25;0;0;36;2012;sub;18
10;15;0;0;25;2013;sub;18
5;12;0;0;17;2014;sub;18
7;17;1;0;25;2015;sub;18
1;5;0;0;6;2016;sub;18
5;6;0;0;11;2017;sub;18
3;8;1;0;12;2018;sub;18
4;9;0;1;14;2008;con;18
2;6;0;0;8;2009;con;18
2;9;0;0;11;2010;con;18
1;1;0;0;2;2011;con;18
1;1;0;0;2;2012;con;18
2;1;0;0;3;2013;con;18
1;9;0;0;10;2014;con;18
2;7;0;0;9;2015;con;18
0;9;0;0;9;2016;con;18
1;4;0;0;5;2017;con;18
2;7;0;0;9;2018;con;18
0;0;0;0;0;2008;esp;18
0;0;0;0;0;2009;esp;18
0;0;0;0;0;2010;esp;18
0;0;0;0;0;2011;esp;18
0;0;0;0;0;2012;esp;18
1;0;0;0;1;2013;esp;18
0;1;0;0;1;2014;esp;18
0;1;0;0;1;2015;esp;18
0;0;0;0;0;2016;esp;18
1;0;0;0;1;2017;esp;18
0;0;0;0;0;2018;esp;18
0;10;0;0;10;2008;nas;18
4;9;0;0;13;2009;nas;18
1;1;0;0;2;2010;nas;18
2;2;0;0;4;2011;nas;18
1;5;0;0;6;2012;nas;18
2;10;0;0;12;2013;nas;18
2;4;1;0;7;2014;nas;18
0;2;0;0;2;2015;nas;18
0;7;0;0;7;2016;nas;18
0;2;0;0;2;2017;nas;18
2;2;0;0;4;2018;nas;18
9;30;2;0;41;2008;sub;19
13;24;0;0;37;2009;sub;19
10;32;2;0;44;2010;sub;19
24;43;1;0;68;2011;sub;19
25;32;0;0;57;2012;sub;19
36;58;1;0;95;2013;sub;19
27;41;1;0;69;2014;sub;19
19;32;2;0;53;2015;sub;19
19;32;1;0;52;2016;sub;19
26;41;2;0;69;2017;sub;19
31;46;3;0;80;2018;sub;19
538;476;72;2;1088;2008;con;19
606;487;63;5;1161;2009;con;19
558;459;72;2;1091;2010;con;19
649;463;61;0;1173;2011;con;19
534;465;52;0;1051;2012;con;19
628;486;50;1;1165;2013;con;19
717;539;48;0;1304;2014;con;19
671;421;61;0;1153;2015;con;19
642;438;51;0;1131;2016;con;19
593;418;41;0;1052;2017;con;19
548;391;40;0;979;2018;con;19
27;32;7;1;67;2008;esp;19
43;29;2;1;75;2009;esp;19
24;25;6;2;57;2010;esp;19
26;21;5;0;52;2011;esp;19
34;28;6;0;68;2012;esp;19
37;24;3;0;64;2013;esp;19
42;30;6;0;78;2014;esp;19
49;13;0;0;62;2015;esp;19
23;15;4;0;42;2016;esp;19
32;14;1;0;47;2017;esp;19
25;21;3;0;49;2018;esp;19
28;56;1;0;85;2008;nas;19
32;52;2;0;86;2009;nas;19
16;26;0;1;43;2010;nas;19
16;29;0;0;45;2011;nas;19
12;28;2;0;42;2012;nas;19
11;22;0;0;33;2013;nas;19
15;19;0;1;35;2014;nas;19
12;22;0;0;34;2015;nas;19
15;9;0;0;24;2016;nas;19
7;17;2;0;26;2017;nas;19
22;23;1;0;46;2018;nas;19
301;543;15;4;863;2008;sub;20
229;474;14;2;719;2009;sub;20
291;545;13;0;849;2010;sub;20
259;439;9;1;708;2011;sub;20
264;460;12;0;736;2012;sub;20
249;426;10;0;685;2013;sub;20
233;428;4;0;665;2014;sub;20
242;393;9;0;644;2015;sub;20
223;384;12;0;619;2016;sub;20
217;379;7;0;603;2017;sub;20
218;332;10;0;560;2018;sub;20
766;1232;96;9;2103;2008;con;20
817;1199;78;10;2104;2009;con;20
764;976;80;3;1823;2010;con;20
824;998;64;1;1887;2011;con;20
728;1010;52;0;1790;2012;con;20
811;956;63;0;1830;2013;con;20
774;985;50;0;1809;2014;con;20
791;975;40;0;1806;2015;con;20
755;978;40;0;1773;2016;con;20
684;893;33;0;1610;2017;con;20
612;847;35;0;1494;2018;con;20
53;89;9;1;152;2008;esp;20
71;80;15;0;166;2009;esp;20
78;82;5;2;167;2010;esp;20
66;75;10;0;151;2011;esp;20
42;62;16;0;120;2012;esp;20
45;59;12;0;116;2013;esp;20
56;49;2;0;107;2014;esp;20
53;69;5;0;127;2015;esp;20
44;68;3;0;115;2016;esp;20
60;49;6;0;115;2017;esp;20
41;43;4;0;88;2018;esp;20
203;395;10;1;609;2008;nas;20
159;418;17;1;595;2009;nas;20
155;273;9;0;437;2010;nas;20
124;227;6;0;357;2011;nas;20
102;175;8;0;285;2012;nas;20
109;184;2;0;295;2013;nas;20
69;129;4;0;202;2014;nas;20
63;67;2;0;132;2015;nas;20
33;76;2;0;111;2016;nas;20
34;54;3;0;91;2017;nas;20
77;99;3;0;179;2018;nas;20
175;548;19;4;746;2008;sub;21
171;431;17;2;621;2009;sub;21
156;457;17;1;631;2010;sub;21
175;446;20;0;641;2011;sub;21
171;484;19;1;675;2012;sub;21
170;370;12;0;552;2013;sub;21
203;417;15;0;635;2014;sub;21
182;468;11;0;661;2015;sub;21
200;529;14;0;743;2016;sub;21
211;470;13;0;694;2017;sub;21
220;394;6;0;620;2018;sub;21
2213;2330;272;21;4836;2008;con;21
2377;2208;262;28;4875;2009;con;21
2533;2137;274;6;4950;2010;con;21
2349;1983;218;2;4552;2011;con;21
2577;2070;241;0;4888;2012;con;21
2566;1987;228;0;4781;2013;con;21
2655;2071;188;0;4914;2014;con;21
2878;2178;243;0;5299;2015;con;21
2859;2054;228;0;5141;2016;con;21
2693;2015;226;0;4934;2017;con;21
2472;1853;179;0;4504;2018;con;21
83;64;10;0;157;2008;esp;21
83;97;12;0;192;2009;esp;21
102;75;11;2;190;2010;esp;21
97;110;10;0;217;2011;esp;21
83;77;13;0;173;2012;esp;21
113;72;7;0;192;2013;esp;21
87;61;6;0;154;2014;esp;21
86;71;4;0;161;2015;esp;21
93;67;5;0;165;2016;esp;21
69;64;3;0;136;2017;esp;21
60;50;8;0;118;2018;esp;21
162;429;29;2;622;2008;nas;21
210;489;29;2;730;2009;nas;21
170;374;16;2;562;2010;nas;21
135;328;12;0;475;2011;nas;21
131;340;18;0;489;2012;nas;21
150;290;4;0;444;2013;nas;21
114;209;20;0;343;2014;nas;21
110;131;4;0;245;2015;nas;21
62;108;7;0;177;2016;nas;21
72;93;2;0;167;2017;nas;21
95;129;2;0;226;2018;nas;21
726;1781;36;8;2551;2008;sub;22
690;1908;43;10;2651;2009;sub;22
676;1804;25;1;2506;2010;sub;22
686;1732;33;0;2451;2011;sub;22
674;1499;31;0;2204;2012;sub;22
651;1406;19;0;2076;2013;sub;22
567;1323;19;0;1909;2014;sub;22
629;1232;32;0;1893;2015;sub;22
539;1203;18;0;1760;2016;sub;22
559;1188;16;0;1763;2017;sub;22
547;1105;11;0;1663;2018;sub;22
968;1816;89;8;2881;2008;con;22
998;1694;98;18;2808;2009;con;22
982;1702;91;2;2777;2010;con;22
997;1679;96;1;2773;2011;con;22
1106;1848;104;0;3058;2012;con;22
1065;1678;67;0;2810;2013;con;22
1077;1708;60;0;2845;2014;con;22
1221;1824;68;0;3113;2015;con;22
1322;2016;57;0;3395;2016;con;22
1212;1861;49;0;3122;2017;con;22
1077;1796;43;0;2916;2018;con;22
34;65;8;0;107;2008;esp;22
39;80;7;2;128;2009;esp;22
50;78;4;2;134;2010;esp;22
49;77;10;0;136;2011;esp;22
41;73;9;0;123;2012;esp;22
53;76;6;0;135;2013;esp;22
41;59;3;0;103;2014;esp;22
47;78;7;0;132;2015;esp;22
47;53;7;0;107;2016;esp;22
51;57;4;0;112;2017;esp;22
51;43;1;0;95;2018;esp;22
230;741;21;2;994;2008;nas;22
282;713;8;2;1005;2009;nas;22
180;493;10;0;683;2010;nas;22
198;522;16;0;736;2011;nas;22
184;432;5;0;621;2012;nas;22
173;380;3;0;556;2013;nas;22
144;328;5;0;477;2014;nas;22
107;224;2;0;333;2015;nas;22
93;153;1;0;247;2016;nas;22
69;139;1;0;209;2017;nas;22
121;187;2;0;310;2018;nas;22
